1 1 1 1 1 1 1 1 1 1 1 1 1 1 1 1 1 1 1 1 1 1 1 1 1 1 1 1 1 1
1 3 3 3 3 3 3 3 3 3 3 3 3 3 3 3 3 3 3 3 3 3 3 3 3 3 3 3 3 1
1 3 1 1 1 3 1 1 1 1 3 1 1 1 3 1 1 1 1 3 1 1 1 3 1 1 1 1 3 1
1 3 1 0 1 3 1 0 0 1 3 1 0 1 3 1 0 0 1 3 1 0 1 3 1 0 0 1 3 1
1 3 1 1 1 3 1 1 1 1 3 1 1 1 3 1 1 1 1 3 1 1 1 3 1 1 1 1 3 1
1 3 3 3 3 3 3 3 3 3 3 3 3 3 3 3 3 3 3 3 3 3 3 3 3 3 3 3 3 1
1 3 1 1 1 3 1 1 1 1 3 1 1 1 3 1 1 1 1 3 1 1 1 3 1 1 3 1 1 1
1 3 1 3 3 3 1 0 0 1 3 1 0 1 3 1 3 3 3 3 1 3 3 3 1 1 1 1 1 1
1 3 1 10 3 3 1 1 1 1 3 1 0 1 3 1 1 1 1 3 1 1 1 3 1 1 0 1 1 1
1 3 1 3 3 3 1 1 1 3 3 1 0 1 3 3 3 3 1 3 3 3 1 3 3 1 1 1 0 1
1 3 1 1 1 3 1 0 1 1 3 1 1 1 3 1 1 1 1 3 1 1 1 3 3 3 1 0 0 1
1 3 3 3 3 3 1 0 0 1 3 3 3 3 3 3 3 3 3 3 3 3 3 3 3 1 1 1 1 1
1 3 1 1 1 3 3 3 3 3 3 1 1 1 0 1 1 1 3 1 1 3 1 1 3 1 0 0 1 1
1 3 1 1 1 3 1 1 1 1 3 1 4 7 8 5 6 1 3 1 1 1 1 1 3 1 1 1 1 1
1 3 3 3 3 3 1 1 1 1 3 1 1 1 1 1 1 1 3 1 1 0 1 1 3 3 3 3 3 1
1 3 1 1 1 3 3 3 3 3 3 3 3 3 3 3 3 3 3 3 1 1 1 3 3 1 1 1 3 1
1 3 1 0 1 3 1 1 1 1 3 1 1 1 1 3 1 1 1 3 3 1 3 3 3 1 0 1 3 1
1 3 1 0 1 3 1 0 0 1 3 1 0 0 1 3 1 3 3 3 3 3 3 3 3 1 0 1 3 1
1 3 1 1 1 3 1 1 1 1 3 1 1 1 1 3 1 3 3 1 1 1 1 1 3 1 1 1 3 1
1 2 3 3 3 3 1 3 3 3 3 1 9 3 1 3 1 3 3 3 1 0 1 3 3 3 3 3 3 1
1 3 1 1 1 3 1 3 1 1 3 1 3 3 1 3 1 1 1 3 1 1 1 3 1 1 1 1 3 1
1 3 1 0 1 3 3 3 3 3 3 3 3 3 3 3 3 3 3 3 3 3 3 3 1 1 1 1 3 1
1 3 1 1 1 3 1 1 1 1 1 1 3 1 1 1 1 3 1 1 3 3 1 3 3 3 3 3 3 1
1 3 3 3 3 3 1 3 1 1 3 1 3 1 0 0 1 3 1 1 1 3 1 3 1 1 1 1 3 1
1 3 1 1 1 3 1 3 3 3 3 1 3 1 1 1 1 3 1 3 1 1 1 3 1 0 0 1 3 1
1 3 1 0 1 3 1 3 1 1 3 1 3 1 3 3 1 3 1 3 3 1 1 3 1 0 0 1 3 1
1 3 1 0 1 3 1 3 1 1 3 1 3 1 3 3 1 3 1 3 3 3 1 3 1 0 0 1 3 1
1 3 1 1 1 3 3 3 1 1 3 3 3 3 3 3 3 3 3 3 1 3 3 3 1 1 1 1 3 1
1 3 3 3 3 3 3 3 1 1 1 1 1 1 1 1 1 1 1 1 1 1 1 3 3 3 3 3 3 1
1 1 1 1 1 1 1 1 1 1 1 1 1 1 1 1 1 1 1 1 1 1 1 1 1 1 1 1 1 1